NO xpm_files/TECH_1A_1.xpm      
SO xpm_files/TECH_2A_1.xpm
WE xpm_files/TECH_3A_1.xpm
EA xpm_files/TECH_4A_1.xpm

F 53,81,92
C 108,122,137
11111111111111111111111111111111
11000000000000000000000000000001
10000000000000000000000000000001
10000000000000000000000000000001
10000000000000000000S00000000001
10000000000000000000000000000001
10000000000000000000000000000001
10000000000000000000000000000001
11111110000000000000000011111111
10000000000000000000000000000001
10000000000000000000000000000001
10000000000000000000000000000001
10000000000000000000000000000001
10000000000000010000000000000001
10000000000000000000000000000001
10000000000000000000000000000001
10000000000000000000000000000001
10000000000000000000000000000001
10000000000000000000000000000001
10000000000000000000000000000001
10000000000000000000000000000001
10000000000000000000000000000001
10000000000000000000000000000001
10000000000000000000000000000001
10000000000000010000000000000001
11111111111111111111111111111111