NO parsing/xpmfile/NO.xpm
SO parsing/xpmfile/SO.xpm
WE parsing/xpmfile/WE.xpm
EA parsing/xpmfile/EA.xpm


    F    22,       200   ,    0 
C              225  ,  25   ,0                 

1111111111111111111
1000101000000001001
1000011000000011001
100N00100000010001
1000000001000000001
1000000000111100001
1001111100000000001
1000000000000000101
1001100001000011111
1000000000010000001
1111111111111111111