111111111111111111111111111111
100000000000000000000000000001
110000000000001000000000000001
100000001111111111110000000001
100000000000001000000000000001
100000000011111000000000000001
100000000010000000011111111111
10000000001000000001
10000000001000000S01
10000000001000000001
100000000010110110011111111111
100000000000000010000000000001
100000000111110001000000000001
100000000000000010000000000001
100000000000111110000000000001
100000000000000000000000000001
111111111111111111111111111111