



NO   xpmfile/NO.xpm


SO   xpmfile/SO.xpm                                     

WE   xpmfile/WE.xpm


EA   xpmfile/EA.xpm


F 220   ,      100,       0

C              225,30,0       

111111111111111111111111111111
100000000000000000000000000001
100000000000000000000000000001        
100000000000000000000000000001
100000000000000000000000000001
100000000000000000000000000001  
10000000000000000000000000001 
10000000000000000000000000001
10000000000000000N00000000001
10000000000000000000000000001
10000000000000000000000000001
100000000000000000000000000001
100000000000000000000000000001
100000000000000000000000000001
100000000000000000000000000001
100000000000000000000000000001
111111111111111111111111111111