
NO   xpmfile/NO.xpm


SO   xpmfile/SO.xpm                                     

WE   xpmfile/WE.xpm






F         220,     255  ,78






EA   xpmfile/EA.xpm






C                     255   ,   200, 65       

            

                 






















        1111111111111111111111111       
        1000000000000000000000001           
        1000000000000000000000001           
        1000000000000000000000001           
        1000000000000000000000001           
        1000000000000000000000001           
        1000000000000000000000001           
        1000000000000000000000001                    
        1000000000000000000000001           
111111111000000000000000000011111           
10000000000000000000000000001                                                               
10000000000000000000000000001                                                    
10000000000000000000000000001                                                
11000000110101011100000010001           
1111111110000000110000001000111111111111111111111111111
        10000000001100000000000011000000000110000011101           
        10110011111111111111110011000000000110000011101                                            
        1001001              10000000000000001110000001111111111                               
111111111000001              11000000100011000000000110000011101
100000000000001              101010100100011000000000110000011101                               
111111111011001              11110000000000111100000000011000001                               
100000000011001              11110111111111111111111111111111111
111101111111111              110000001000110111           
10000000000000111111111111111100000000011000001111111111       
10000000000000001101010010001100000000011000001110100001           
10000000000000001101010011111111111111011000010000111111           
11110111111111011101010011        111111111111111101           
11000000110101011100000011     11110000000011000001111111111111111               
11111111100000001100000011     11100000000011000001110111111111111           
        111111111111111111     111111100000000011000001110111111111111           
        100000000011000001     100001100000000011000001110111111111111           
        101100000111000001     100001100000000011000001110111111111111           
        100100000000000001     111111111111111111111111111100000000001           
11111111101100000111000001                                10011110001111111111111111111111111           
10000000001100000111011111                                11111110000000001100000111011111111           
11110111111111011100000011                                11100000000011000001110000000000001           
11110111111111E11101010011                                10000000000000000001100000000000011           
11000000110101011100000011                               10000000000011000001110111111111111           
10000000000000001100000011                                11000011101111111111111000000000111           
11110111111111011111111111                                10000000000011000111111111111111111           
1111011111111101                                          111111111111111111           
1100000011010101                              
1000000000000001                   111111111           
1000000000000001                   110010001           
1111011111111101                   100010001111111111111111111          
11110111111111011111111111111111111100000000000000000110000011           
11000000110101011100000010000000000000000000000000000000000001           
11000000110101011100000010001111111111111111111111111111111111           
10000000000000001100000010001           
10000000000000001101010010001           
11110111111111011101010010001      
1100000011010101110000001000111111111111111111111111111111111111111111111111111111           
1100000011010101110000001000000000000000000000000000000000000000000000000000000001           
1100000011010101110000001000000000000000000000000000000000000000000000000000000001          
1100000011010101110000001000111111111111111111111111111111111111111111111111111111           
11000000110101011100000010001
10000000000000001100000010001
10000000000000001101010010001           
11110111111111011100000010001
11110111111111011101010010001
11000000110101011100000010001           
10000000000000001100000010001           
10000000000000001101010010001           
11000001111101011111111110001           
11110111  1110101   101111011                  
11111111  1111111   111111111