111111111111111111111111111111
100000000000000000000000000001
100000000000000000000000000001
100N00000000000000000000000001
100000000000000000000000000001
100000000000000000000000000001
100000719071190107190719000001
100000100010010001000100000001
100000219011110101190119000001
100000001010010101000100000001
100000213030030303000213000001
100000000000000000000000000001
100000000000000000000000000001
100000000000000000000000000001
100000000000000000000000000001
100000000000000000000000000001
111111111111111111111111111111